CFF--P-C---PF-CPC-I--------C-P-FFFF--
FPPP-P-PPP-PP-PP-PPPPPPPPP-P-P-PCP-P-
---P-P---P-------P-------P-P---P-P-PC
-P-P-PPP-PPPPPPPPP-PPP-P-P-PPPPPPPPP-
CP-P-----PC---CP---P---P-P-----------
-P-P-PPPPPPPPP-P-PPP-PPP-PPPPPPPPPPP-
-P-PCP--C----P-P-PCP---P-------P-----
-P-PPP-PPPPPFP-P-P-PPP-P-PPPPP-P-PPP-
-P-----P-----P--CP-PCP-P-----P-PCP---
-PPPPPPP-PPPPPPPPP-P-P-P-PPP-PPP-PPP-
-P---P---P------------FP-P---P---PFFF
-P-P-P-PPPCPPPPPPPPPPPPPPP-PPP-PPPPP-
-P-P-P---P-P----------F--PCP---PCP--C
-P-P-PCP-P-PPPPP-P-PPPPP-P-P-PPP-P-PP
-P-P-P-P-F-P---P-P---PC----P-----P---
PP-P-PPPPPPP-P-PPPPP-PPPPPPPPPPP-PPP-
---P-----P-P-P-C-P---P------P-CP-----
-PCPCPPP-P-P-PFP-P-PPP-P-PPFP--PPPPP-
-PPPPP---P---P-----P---P---FP--P---P-
-P---PCP-PPP-PPPPP-P-PPPPPPF---P-P-P-
-P-P-P---P-C-P---PCP-PCPC--F---P-P-P-
CP-PCPPP-P-PPP-P-PPC-P-PPPPPPP-PCP-P-
---P-P---P-----P-----P-------P---P-P-
-PPP-P-PPP-PPPPPPPPPPP-PPPPP-PPPPP-P-
-F-F-P-----P---P--C-CP-PCCCPCPCP-P---
PPPP-PPPPPPCPP-P-PPP-P-PPP-P-P-P-PPP-
-----P-------P-P---P-F-P---P-------P-
-PPP-P-PPPPP-P-PPP-PPPPP-P-PPPPPPP-P-
-P---P---PCP-P-F-P-P--C--F--CPC--P---
-PPPPPPP-P-P-P-PPP-P-PPP-PPPPP-P-PPPP
-P-----P-P-P-P---P-PC--PC---C-CP---PC
CP-PPP-P-P-P-PPP-P-PPPPPPPPPPPPP-P-P-
-P-P-P-P--FP---P-----P-----------P---
-P-P-P-PPP-PPP-PPPPP-P-PPPPPPPPPPPPP-
-P-P-P--CP-PCP-P---P---P-P---P--CP---
-P-PCP-PPP-P-P-P-P-PPPPP-P-PCP-P-P-PP
-FF--P----F-CP---PL-----F--PF--P----F
